#A#############
#             #
# #### ## ## ##
#    # ## #   #
#### #  # # ###
#     #  #  # #
## ##  # # #  #
## # # # # # ##
##   # # # # ##
# ###  # # # ##
#    ### #  ###
####      ##  #
# # #####   # #
#         #   #
#############B#