####A###
##     #
#  ### #
# ###  #
##### ##
#B    ##
########